"filename", "language", "XML", "Java", "comment", "blank", "total"
"c:\Users\Edolk\Desktop\Other java projects\ZircPrototype\zircdemo\pom.xml", "XML", 109, 0, 3, 17, 129
"c:\Users\Edolk\Desktop\Other java projects\ZircPrototype\zircdemo\src\main\java\edolkh1\zirc\App.java", "Java", 0, 17, 0, 6, 23
"c:\Users\Edolk\Desktop\Other java projects\ZircPrototype\zircdemo\src\main\java\edolkh1\zirc\Dungeon.java", "Java", 0, 102, 0, 28, 130
"c:\Users\Edolk\Desktop\Other java projects\ZircPrototype\zircdemo\src\main\java\edolkh1\zirc\Line.java", "Java", 0, 63, 0, 16, 79
"c:\Users\Edolk\Desktop\Other java projects\ZircPrototype\zircdemo\src\main\java\edolkh1\zirc\Path.java", "Java", 0, 171, 1, 26, 198
"c:\Users\Edolk\Desktop\Other java projects\ZircPrototype\zircdemo\src\main\java\edolkh1\zirc\PathFinder.java", "Java", 0, 29, 0, 9, 38
"c:\Users\Edolk\Desktop\Other java projects\ZircPrototype\zircdemo\src\main\java\edolkh1\zirc\display\Cursor.java", "Java", 0, 93, 0, 11, 104
"c:\Users\Edolk\Desktop\Other java projects\ZircPrototype\zircdemo\src\main\java\edolkh1\zirc\display\Display.java", "Java", 0, 199, 2, 39, 240
"c:\Users\Edolk\Desktop\Other java projects\ZircPrototype\zircdemo\src\main\java\edolkh1\zirc\display\EquipmentMenu.java", "Java", 0, 185, 12, 52, 249
"c:\Users\Edolk\Desktop\Other java projects\ZircPrototype\zircdemo\src\main\java\edolkh1\zirc\display\ExamineMenu.java", "Java", 0, 144, 0, 54, 198
"c:\Users\Edolk\Desktop\Other java projects\ZircPrototype\zircdemo\src\main\java\edolkh1\zirc\display\FloorMenu.java", "Java", 0, 878, 5, 108, 991
"c:\Users\Edolk\Desktop\Other java projects\ZircPrototype\zircdemo\src\main\java\edolkh1\zirc\display\ItemContextMenu.java", "Java", 0, 218, 0, 31, 249
"c:\Users\Edolk\Desktop\Other java projects\ZircPrototype\zircdemo\src\main\java\edolkh1\zirc\display\ItemSelectMenu.java", "Java", 0, 279, 0, 45, 324
"c:\Users\Edolk\Desktop\Other java projects\ZircPrototype\zircdemo\src\main\java\edolkh1\zirc\display\Menu.java", "Java", 0, 38, 0, 13, 51
"c:\Users\Edolk\Desktop\Other java projects\ZircPrototype\zircdemo\src\main\java\edolkh1\zirc\display\PauseMenu.java", "Java", 0, 51, 0, 14, 65
"c:\Users\Edolk\Desktop\Other java projects\ZircPrototype\zircdemo\src\main\java\edolkh1\zirc\floorgeneration\ArmorFactory.java", "Java", 0, 29, 0, 8, 37
"c:\Users\Edolk\Desktop\Other java projects\ZircPrototype\zircdemo\src\main\java\edolkh1\zirc\floorgeneration\DefaultFloorGenerator.java", "Java", 0, 171, 1, 27, 199
"c:\Users\Edolk\Desktop\Other java projects\ZircPrototype\zircdemo\src\main\java\edolkh1\zirc\floorgeneration\EntityFactory.java", "Java", 0, 32, 0, 5, 37
"c:\Users\Edolk\Desktop\Other java projects\ZircPrototype\zircdemo\src\main\java\edolkh1\zirc\floorgeneration\FloorGenerator.java", "Java", 0, 38, 0, 11, 49
"c:\Users\Edolk\Desktop\Other java projects\ZircPrototype\zircdemo\src\main\java\edolkh1\zirc\floorgeneration\ItemFactory.java", "Java", 0, 81, 0, 8, 89
"c:\Users\Edolk\Desktop\Other java projects\ZircPrototype\zircdemo\src\main\java\edolkh1\zirc\floorgeneration\Pool.java", "Java", 0, 42, 0, 11, 53
"c:\Users\Edolk\Desktop\Other java projects\ZircPrototype\zircdemo\src\main\java\edolkh1\zirc\floorgeneration\Pools.java", "Java", 0, 46, 0, 13, 59
"c:\Users\Edolk\Desktop\Other java projects\ZircPrototype\zircdemo\src\main\java\edolkh1\zirc\floorgeneration\WeaponFactory.java", "Java", 0, 29, 0, 9, 38
"c:\Users\Edolk\Desktop\Other java projects\ZircPrototype\zircdemo\src\main\java\edolkh1\zirc\gamelogic\Aimable.java", "Java", 0, 8, 0, 3, 11
"c:\Users\Edolk\Desktop\Other java projects\ZircPrototype\zircdemo\src\main\java\edolkh1\zirc\gamelogic\Armed.java", "Java", 0, 18, 0, 4, 22
"c:\Users\Edolk\Desktop\Other java projects\ZircPrototype\zircdemo\src\main\java\edolkh1\zirc\gamelogic\Armored.java", "Java", 0, 18, 0, 4, 22
"c:\Users\Edolk\Desktop\Other java projects\ZircPrototype\zircdemo\src\main\java\edolkh1\zirc\gamelogic\Consumable.java", "Java", 0, 8, 0, 3, 11
"c:\Users\Edolk\Desktop\Other java projects\ZircPrototype\zircdemo\src\main\java\edolkh1\zirc\gamelogic\Damageable.java", "Java", 0, 6, 0, 3, 9
"c:\Users\Edolk\Desktop\Other java projects\ZircPrototype\zircdemo\src\main\java\edolkh1\zirc\gamelogic\DropsXP.java", "Java", 0, 4, 0, 2, 6
"c:\Users\Edolk\Desktop\Other java projects\ZircPrototype\zircdemo\src\main\java\edolkh1\zirc\gamelogic\Examinable.java", "Java", 0, 11, 0, 4, 15
"c:\Users\Edolk\Desktop\Other java projects\ZircPrototype\zircdemo\src\main\java\edolkh1\zirc\gamelogic\Experiential.java", "Java", 0, 6, 0, 1, 7
"c:\Users\Edolk\Desktop\Other java projects\ZircPrototype\zircdemo\src\main\java\edolkh1\zirc\gamelogic\Flammable.java", "Java", 0, 6, 0, 3, 9
"c:\Users\Edolk\Desktop\Other java projects\ZircPrototype\zircdemo\src\main\java\edolkh1\zirc\gamelogic\HasAccuracy.java", "Java", 0, 4, 0, 2, 6
"c:\Users\Edolk\Desktop\Other java projects\ZircPrototype\zircdemo\src\main\java\edolkh1\zirc\gamelogic\HasDodge.java", "Java", 0, 4, 0, 2, 6
"c:\Users\Edolk\Desktop\Other java projects\ZircPrototype\zircdemo\src\main\java\edolkh1\zirc\gamelogic\HasDrops.java", "Java", 0, 28, 0, 7, 35
"c:\Users\Edolk\Desktop\Other java projects\ZircPrototype\zircdemo\src\main\java\edolkh1\zirc\gamelogic\HasInventory.java", "Java", 0, 39, 0, 9, 48
"c:\Users\Edolk\Desktop\Other java projects\ZircPrototype\zircdemo\src\main\java\edolkh1\zirc\gamelogic\HasResistances.java", "Java", 0, 13, 0, 4, 17
"c:\Users\Edolk\Desktop\Other java projects\ZircPrototype\zircdemo\src\main\java\edolkh1\zirc\gamelogic\Interactable.java", "Java", 0, 5, 0, 3, 8
"c:\Users\Edolk\Desktop\Other java projects\ZircPrototype\zircdemo\src\main\java\edolkh1\zirc\gamelogic\Levelable.java", "Java", 0, 4, 0, 2, 6
"c:\Users\Edolk\Desktop\Other java projects\ZircPrototype\zircdemo\src\main\java\edolkh1\zirc\gamelogic\LightSource.java", "Java", 0, 4, 0, 2, 6
"c:\Users\Edolk\Desktop\Other java projects\ZircPrototype\zircdemo\src\main\java\edolkh1\zirc\gamelogic\OverridesAttack.java", "Java", 0, 5, 0, 3, 8
"c:\Users\Edolk\Desktop\Other java projects\ZircPrototype\zircdemo\src\main\java\edolkh1\zirc\gamelogic\OverridesMovement.java", "Java", 0, 6, 0, 3, 9
"c:\Users\Edolk\Desktop\Other java projects\ZircPrototype\zircdemo\src\main\java\edolkh1\zirc\gamelogic\Scrollable.java", "Java", 0, 6, 0, 3, 9
"c:\Users\Edolk\Desktop\Other java projects\ZircPrototype\zircdemo\src\main\java\edolkh1\zirc\gamelogic\SelfAware.java", "Java", 0, 12, 0, 3, 15
"c:\Users\Edolk\Desktop\Other java projects\ZircPrototype\zircdemo\src\main\java\edolkh1\zirc\gamelogic\Triggerable.java", "Java", 0, 6, 0, 2, 8
"c:\Users\Edolk\Desktop\Other java projects\ZircPrototype\zircdemo\src\main\java\edolkh1\zirc\gamelogic\Upgradable.java", "Java", 0, 4, 0, 2, 6
"c:\Users\Edolk\Desktop\Other java projects\ZircPrototype\zircdemo\src\main\java\edolkh1\zirc\gamelogic\Upgrader.java", "Java", 0, 4, 0, 2, 6
"c:\Users\Edolk\Desktop\Other java projects\ZircPrototype\zircdemo\src\main\java\edolkh1\zirc\gamelogic\behavior\Behavable.java", "Java", 0, 5, 0, 5, 10
"c:\Users\Edolk\Desktop\Other java projects\ZircPrototype\zircdemo\src\main\java\edolkh1\zirc\gamelogic\behavior\Behavior.java", "Java", 0, 4, 0, 4, 8
"c:\Users\Edolk\Desktop\Other java projects\ZircPrototype\zircdemo\src\main\java\edolkh1\zirc\gamelogic\behavior\HasBehavior.java", "Java", 0, 13, 0, 7, 20
"c:\Users\Edolk\Desktop\Other java projects\ZircPrototype\zircdemo\src\main\java\edolkh1\zirc\gamelogic\combat\OnAttack.java", "Java", 0, 5, 0, 3, 8
"c:\Users\Edolk\Desktop\Other java projects\ZircPrototype\zircdemo\src\main\java\edolkh1\zirc\gamelogic\combat\OnAttacked.java", "Java", 0, 5, 0, 3, 8
"c:\Users\Edolk\Desktop\Other java projects\ZircPrototype\zircdemo\src\main\java\edolkh1\zirc\gamelogic\combat\OnCrit.java", "Java", 0, 5, 0, 3, 8
"c:\Users\Edolk\Desktop\Other java projects\ZircPrototype\zircdemo\src\main\java\edolkh1\zirc\gamelogic\combat\OnCritted.java", "Java", 0, 5, 0, 3, 8
"c:\Users\Edolk\Desktop\Other java projects\ZircPrototype\zircdemo\src\main\java\edolkh1\zirc\gamelogic\combat\OnHit.java", "Java", 0, 5, 0, 3, 8
"c:\Users\Edolk\Desktop\Other java projects\ZircPrototype\zircdemo\src\main\java\edolkh1\zirc\gamelogic\combat\OnHitted.java", "Java", 0, 5, 0, 3, 8
"c:\Users\Edolk\Desktop\Other java projects\ZircPrototype\zircdemo\src\main\java\edolkh1\zirc\gamelogic\combat\OnMiss.java", "Java", 0, 5, 0, 3, 8
"c:\Users\Edolk\Desktop\Other java projects\ZircPrototype\zircdemo\src\main\java\edolkh1\zirc\gamelogic\combat\OnMissed.java", "Java", 0, 5, 0, 3, 8
"c:\Users\Edolk\Desktop\Other java projects\ZircPrototype\zircdemo\src\main\java\edolkh1\zirc\gamelogic\resistances\FlatResistance.java", "Java", 0, 28, 0, 9, 37
"c:\Users\Edolk\Desktop\Other java projects\ZircPrototype\zircdemo\src\main\java\edolkh1\zirc\gamelogic\resistances\PercentageResistance.java", "Java", 0, 37, 0, 11, 48
"c:\Users\Edolk\Desktop\Other java projects\ZircPrototype\zircdemo\src\main\java\edolkh1\zirc\gamelogic\resistances\RangeResistance.java", "Java", 0, 44, 0, 15, 59
"c:\Users\Edolk\Desktop\Other java projects\ZircPrototype\zircdemo\src\main\java\edolkh1\zirc\gamelogic\resistances\Resistance.java", "Java", 0, 24, 0, 12, 36
"c:\Users\Edolk\Desktop\Other java projects\ZircPrototype\zircdemo\src\main\java\edolkh1\zirc\gameobjects\ArmorSlot.java", "Java", 0, 39, 0, 11, 50
"c:\Users\Edolk\Desktop\Other java projects\ZircPrototype\zircdemo\src\main\java\edolkh1\zirc\gameobjects\DamageType.java", "Java", 0, 8, 0, 3, 11
"c:\Users\Edolk\Desktop\Other java projects\ZircPrototype\zircdemo\src\main\java\edolkh1\zirc\gameobjects\DisplayableTile.java", "Java", 0, 90, 0, 22, 112
"c:\Users\Edolk\Desktop\Other java projects\ZircPrototype\zircdemo\src\main\java\edolkh1\zirc\gameobjects\Floor.java", "Java", 0, 342, 0, 79, 421
"c:\Users\Edolk\Desktop\Other java projects\ZircPrototype\zircdemo\src\main\java\edolkh1\zirc\gameobjects\Space.java", "Java", 0, 187, 8, 40, 235
"c:\Users\Edolk\Desktop\Other java projects\ZircPrototype\zircdemo\src\main\java\edolkh1\zirc\gameobjects\WeaponSlot.java", "Java", 0, 36, 0, 13, 49
"c:\Users\Edolk\Desktop\Other java projects\ZircPrototype\zircdemo\src\main\java\edolkh1\zirc\gameobjects\enchantments\ArmorEnchantment.java", "Java", 0, 3, 0, 3, 6
"c:\Users\Edolk\Desktop\Other java projects\ZircPrototype\zircdemo\src\main\java\edolkh1\zirc\gameobjects\enchantments\Enchantment.java", "Java", 0, 17, 0, 8, 25
"c:\Users\Edolk\Desktop\Other java projects\ZircPrototype\zircdemo\src\main\java\edolkh1\zirc\gameobjects\enchantments\Lucky.java", "Java", 0, 19, 0, 7, 26
"c:\Users\Edolk\Desktop\Other java projects\ZircPrototype\zircdemo\src\main\java\edolkh1\zirc\gameobjects\enchantments\WeaponEnchantment.java", "Java", 0, 3, 0, 3, 6
"c:\Users\Edolk\Desktop\Other java projects\ZircPrototype\zircdemo\src\main\java\edolkh1\zirc\gameobjects\entities\Animal.java", "Java", 0, 171, 6, 23, 200
"c:\Users\Edolk\Desktop\Other java projects\ZircPrototype\zircdemo\src\main\java\edolkh1\zirc\gameobjects\entities\Chest.java", "Java", 0, 60, 0, 16, 76
"c:\Users\Edolk\Desktop\Other java projects\ZircPrototype\zircdemo\src\main\java\edolkh1\zirc\gameobjects\entities\DireRat.java", "Java", 0, 39, 0, 13, 52
"c:\Users\Edolk\Desktop\Other java projects\ZircPrototype\zircdemo\src\main\java\edolkh1\zirc\gameobjects\entities\Door.java", "Java", 0, 46, 0, 15, 61
"c:\Users\Edolk\Desktop\Other java projects\ZircPrototype\zircdemo\src\main\java\edolkh1\zirc\gameobjects\entities\Entity.java", "Java", 0, 330, 16, 86, 432
"c:\Users\Edolk\Desktop\Other java projects\ZircPrototype\zircdemo\src\main\java\edolkh1\zirc\gameobjects\entities\EvaporatedSlime.java", "Java", 0, 74, 0, 18, 92
"c:\Users\Edolk\Desktop\Other java projects\ZircPrototype\zircdemo\src\main\java\edolkh1\zirc\gameobjects\entities\PlayerEntity.java", "Java", 0, 161, 0, 33, 194
"c:\Users\Edolk\Desktop\Other java projects\ZircPrototype\zircdemo\src\main\java\edolkh1\zirc\gameobjects\entities\Rat.java", "Java", 0, 53, 0, 16, 69
"c:\Users\Edolk\Desktop\Other java projects\ZircPrototype\zircdemo\src\main\java\edolkh1\zirc\gameobjects\entities\Slime.java", "Java", 0, 140, 0, 27, 167
"c:\Users\Edolk\Desktop\Other java projects\ZircPrototype\zircdemo\src\main\java\edolkh1\zirc\gameobjects\entities\Snake.java", "Java", 0, 61, 0, 16, 77
"c:\Users\Edolk\Desktop\Other java projects\ZircPrototype\zircdemo\src\main\java\edolkh1\zirc\gameobjects\entities\Spider.java", "Java", 0, 403, 18, 64, 485
"c:\Users\Edolk\Desktop\Other java projects\ZircPrototype\zircdemo\src\main\java\edolkh1\zirc\gameobjects\entities\ThrownItem.java", "Java", 0, 84, 0, 15, 99
"c:\Users\Edolk\Desktop\Other java projects\ZircPrototype\zircdemo\src\main\java\edolkh1\zirc\gameobjects\entities\Wall.java", "Java", 0, 55, 0, 13, 68
"c:\Users\Edolk\Desktop\Other java projects\ZircPrototype\zircdemo\src\main\java\edolkh1\zirc\gameobjects\entities\statuses\Burning.java", "Java", 0, 89, 0, 17, 106
"c:\Users\Edolk\Desktop\Other java projects\ZircPrototype\zircdemo\src\main\java\edolkh1\zirc\gameobjects\entities\statuses\Flying.java", "Java", 0, 47, 0, 15, 62
"c:\Users\Edolk\Desktop\Other java projects\ZircPrototype\zircdemo\src\main\java\edolkh1\zirc\gameobjects\entities\statuses\Healing.java", "Java", 0, 37, 0, 10, 47
"c:\Users\Edolk\Desktop\Other java projects\ZircPrototype\zircdemo\src\main\java\edolkh1\zirc\gameobjects\entities\statuses\Poisoned.java", "Java", 0, 39, 0, 11, 50
"c:\Users\Edolk\Desktop\Other java projects\ZircPrototype\zircdemo\src\main\java\edolkh1\zirc\gameobjects\entities\statuses\Status.java", "Java", 0, 21, 0, 11, 32
"c:\Users\Edolk\Desktop\Other java projects\ZircPrototype\zircdemo\src\main\java\edolkh1\zirc\gameobjects\entities\statuses\Wet.java", "Java", 0, 80, 0, 23, 103
"c:\Users\Edolk\Desktop\Other java projects\ZircPrototype\zircdemo\src\main\java\edolkh1\zirc\gameobjects\items\CookedCorpse.java", "Java", 0, 19, 0, 9, 28
"c:\Users\Edolk\Desktop\Other java projects\ZircPrototype\zircdemo\src\main\java\edolkh1\zirc\gameobjects\items\Corpse.java", "Java", 0, 109, 0, 26, 135
"c:\Users\Edolk\Desktop\Other java projects\ZircPrototype\zircdemo\src\main\java\edolkh1\zirc\gameobjects\items\Item.java", "Java", 0, 40, 0, 16, 56
"c:\Users\Edolk\Desktop\Other java projects\ZircPrototype\zircdemo\src\main\java\edolkh1\zirc\gameobjects\items\armor\Armor.java", "Java", 0, 55, 0, 18, 73
"c:\Users\Edolk\Desktop\Other java projects\ZircPrototype\zircdemo\src\main\java\edolkh1\zirc\gameobjects\items\armor\ArmorType.java", "Java", 0, 13, 0, 3, 16
"c:\Users\Edolk\Desktop\Other java projects\ZircPrototype\zircdemo\src\main\java\edolkh1\zirc\gameobjects\items\armor\Chainmail.java", "Java", 0, 16, 0, 6, 22
"c:\Users\Edolk\Desktop\Other java projects\ZircPrototype\zircdemo\src\main\java\edolkh1\zirc\gameobjects\items\armor\Cloak.java", "Java", 0, 15, 0, 5, 20
"c:\Users\Edolk\Desktop\Other java projects\ZircPrototype\zircdemo\src\main\java\edolkh1\zirc\gameobjects\items\armor\IronGreaves.java", "Java", 0, 16, 0, 5, 21
"c:\Users\Edolk\Desktop\Other java projects\ZircPrototype\zircdemo\src\main\java\edolkh1\zirc\gameobjects\items\armor\IronHelm.java", "Java", 0, 16, 0, 5, 21
"c:\Users\Edolk\Desktop\Other java projects\ZircPrototype\zircdemo\src\main\java\edolkh1\zirc\gameobjects\items\armor\LeatherArmor.java", "Java", 0, 16, 0, 7, 23
"c:\Users\Edolk\Desktop\Other java projects\ZircPrototype\zircdemo\src\main\java\edolkh1\zirc\gameobjects\items\armor\LeatherCap.java", "Java", 0, 16, 0, 4, 20
"c:\Users\Edolk\Desktop\Other java projects\ZircPrototype\zircdemo\src\main\java\edolkh1\zirc\gameobjects\items\armor\LeatherGloves.java", "Java", 0, 16, 0, 6, 22
"c:\Users\Edolk\Desktop\Other java projects\ZircPrototype\zircdemo\src\main\java\edolkh1\zirc\gameobjects\items\armor\LeatherPants.java", "Java", 0, 16, 0, 5, 21
"c:\Users\Edolk\Desktop\Other java projects\ZircPrototype\zircdemo\src\main\java\edolkh1\zirc\gameobjects\items\armor\PlateArmor.java", "Java", 0, 17, 0, 6, 23
"c:\Users\Edolk\Desktop\Other java projects\ZircPrototype\zircdemo\src\main\java\edolkh1\zirc\gameobjects\items\armor\PlateGauntlets.java", "Java", 0, 16, 0, 5, 21
"c:\Users\Edolk\Desktop\Other java projects\ZircPrototype\zircdemo\src\main\java\edolkh1\zirc\gameobjects\items\potions\FirePotion.java", "Java", 0, 62, 0, 10, 72
"c:\Users\Edolk\Desktop\Other java projects\ZircPrototype\zircdemo\src\main\java\edolkh1\zirc\gameobjects\items\potions\HealingPotion.java", "Java", 0, 33, 0, 6, 39
"c:\Users\Edolk\Desktop\Other java projects\ZircPrototype\zircdemo\src\main\java\edolkh1\zirc\gameobjects\items\potions\LiquidPotion.java", "Java", 0, 27, 0, 9, 36
"c:\Users\Edolk\Desktop\Other java projects\ZircPrototype\zircdemo\src\main\java\edolkh1\zirc\gameobjects\items\potions\WaterPotion.java", "Java", 0, 39, 0, 9, 48
"c:\Users\Edolk\Desktop\Other java projects\ZircPrototype\zircdemo\src\main\java\edolkh1\zirc\gameobjects\items\scrolls\ScrollOfUpgrade.java", "Java", 0, 57, 0, 14, 71
"c:\Users\Edolk\Desktop\Other java projects\ZircPrototype\zircdemo\src\main\java\edolkh1\zirc\gameobjects\items\weapons\BoStaff.java", "Java", 0, 36, 0, 11, 47
"c:\Users\Edolk\Desktop\Other java projects\ZircPrototype\zircdemo\src\main\java\edolkh1\zirc\gameobjects\items\weapons\Dagger.java", "Java", 0, 31, 0, 8, 39
"c:\Users\Edolk\Desktop\Other java projects\ZircPrototype\zircdemo\src\main\java\edolkh1\zirc\gameobjects\items\weapons\HandAxe.java", "Java", 0, 14, 0, 4, 18
"c:\Users\Edolk\Desktop\Other java projects\ZircPrototype\zircdemo\src\main\java\edolkh1\zirc\gameobjects\items\weapons\ShortSword.java", "Java", 0, 14, 0, 5, 19
"c:\Users\Edolk\Desktop\Other java projects\ZircPrototype\zircdemo\src\main\java\edolkh1\zirc\gameobjects\items\weapons\Weapon.java", "Java", 0, 70, 0, 24, 94
"c:\Users\Edolk\Desktop\Other java projects\ZircPrototype\zircdemo\src\main\java\edolkh1\zirc\gameobjects\terrains\ExposedTrap.java", "Java", 0, 5, 0, 3, 8
"c:\Users\Edolk\Desktop\Other java projects\ZircPrototype\zircdemo\src\main\java\edolkh1\zirc\gameobjects\terrains\Fire.java", "Java", 0, 145, 0, 40, 185
"c:\Users\Edolk\Desktop\Other java projects\ZircPrototype\zircdemo\src\main\java\edolkh1\zirc\gameobjects\terrains\HiddenTrap.java", "Java", 0, 46, 0, 11, 57
"c:\Users\Edolk\Desktop\Other java projects\ZircPrototype\zircdemo\src\main\java\edolkh1\zirc\gameobjects\terrains\OpenDoor.java", "Java", 0, 57, 0, 14, 71
"c:\Users\Edolk\Desktop\Other java projects\ZircPrototype\zircdemo\src\main\java\edolkh1\zirc\gameobjects\terrains\Staircase.java", "Java", 0, 38, 0, 12, 50
"c:\Users\Edolk\Desktop\Other java projects\ZircPrototype\zircdemo\src\main\java\edolkh1\zirc\gameobjects\terrains\Terrain.java", "Java", 0, 11, 0, 6, 17
"c:\Users\Edolk\Desktop\Other java projects\ZircPrototype\zircdemo\src\main\java\edolkh1\zirc\gameobjects\terrains\Trap.java", "Java", 0, 4, 0, 4, 8
"c:\Users\Edolk\Desktop\Other java projects\ZircPrototype\zircdemo\src\main\java\edolkh1\zirc\gameobjects\terrains\gasses\Gas.java", "Java", 0, 155, 0, 38, 193
"c:\Users\Edolk\Desktop\Other java projects\ZircPrototype\zircdemo\src\main\java\edolkh1\zirc\gameobjects\terrains\gasses\Miasma.java", "Java", 0, 51, 0, 25, 76
"c:\Users\Edolk\Desktop\Other java projects\ZircPrototype\zircdemo\src\main\java\edolkh1\zirc\gameobjects\terrains\gasses\Steam.java", "Java", 0, 25, 0, 11, 36
"c:\Users\Edolk\Desktop\Other java projects\ZircPrototype\zircdemo\src\main\java\edolkh1\zirc\gameobjects\terrains\liquids\Liquid.java", "Java", 0, 164, 0, 35, 199
"c:\Users\Edolk\Desktop\Other java projects\ZircPrototype\zircdemo\src\main\java\edolkh1\zirc\gameobjects\terrains\liquids\Water.java", "Java", 0, 53, 0, 10, 63
"c:\Users\Edolk\Desktop\Other java projects\ZircPrototype\zircdemo\src\main\resources\Logback.xml", "XML", 12, 0, 5, 5, 22
"c:\Users\Edolk\Desktop\Other java projects\ZircPrototype\zircdemo\src\test\java\edolkh1\zirc\AppTest.java", "Java", 0, 62, 9, 25, 96
"c:\Users\Edolk\Desktop\Other java projects\ZircPrototype\zircdemo\target\classes\Logback.xml", "XML", 12, 0, 5, 5, 22
"c:\Users\Edolk\Desktop\Other java projects\ZircPrototype\zircdemo\target\classes\edolkh1\zirc\App.class", "Java", 0, 18, 0, 0, 18
"c:\Users\Edolk\Desktop\Other java projects\ZircPrototype\zircdemo\target\classes\edolkh1\zirc\Dungeon.class", "Java", 0, 57, 0, 0, 57
"c:\Users\Edolk\Desktop\Other java projects\ZircPrototype\zircdemo\target\classes\edolkh1\zirc\Line$Point.class", "Java", 0, 8, 0, 0, 8
"c:\Users\Edolk\Desktop\Other java projects\ZircPrototype\zircdemo\target\classes\edolkh1\zirc\Line.class", "Java", 0, 45, 0, 0, 45
"c:\Users\Edolk\Desktop\Other java projects\ZircPrototype\zircdemo\target\classes\edolkh1\zirc\Path$Cords.class", "Java", 0, 7, 0, 0, 7
"c:\Users\Edolk\Desktop\Other java projects\ZircPrototype\zircdemo\target\classes\edolkh1\zirc\Path$Node.class", "Java", 0, 10, 0, 0, 10
"c:\Users\Edolk\Desktop\Other java projects\ZircPrototype\zircdemo\target\classes\edolkh1\zirc\Path$PathNotFoundException.class", "Java", 0, 11, 0, 0, 11
"c:\Users\Edolk\Desktop\Other java projects\ZircPrototype\zircdemo\target\classes\edolkh1\zirc\Path.class", "Java", 0, 65, 0, 0, 65
"c:\Users\Edolk\Desktop\Other java projects\ZircPrototype\zircdemo\target\classes\edolkh1\zirc\PathFinder.class", "Java", 0, 21, 0, 0, 21
"c:\Users\Edolk\Desktop\Other java projects\ZircPrototype\zircdemo\target\classes\edolkh1\zirc\display\Cursor.class", "Java", 0, 42, 0, 0, 42
"c:\Users\Edolk\Desktop\Other java projects\ZircPrototype\zircdemo\target\classes\edolkh1\zirc\display\Display$Mode.class", "Java", 0, 11, 0, 0, 11
"c:\Users\Edolk\Desktop\Other java projects\ZircPrototype\zircdemo\target\classes\edolkh1\zirc\display\Display.class", "Java", 0, 88, 0, 0, 88
"c:\Users\Edolk\Desktop\Other java projects\ZircPrototype\zircdemo\target\classes\edolkh1\zirc\display\EquipmentMenu$ArmorSlotButtonFunction$1.class", "Java", 0, 12, 0, 0, 12
"c:\Users\Edolk\Desktop\Other java projects\ZircPrototype\zircdemo\target\classes\edolkh1\zirc\display\EquipmentMenu$ArmorSlotButtonFunction.class", "Java", 0, 22, 0, 0, 22
"c:\Users\Edolk\Desktop\Other java projects\ZircPrototype\zircdemo\target\classes\edolkh1\zirc\display\EquipmentMenu$ArmorSlotExamineFunction$1.class", "Java", 0, 14, 0, 1, 15
"c:\Users\Edolk\Desktop\Other java projects\ZircPrototype\zircdemo\target\classes\edolkh1\zirc\display\EquipmentMenu$ArmorSlotExamineFunction.class", "Java", 0, 11, 0, 0, 11
"c:\Users\Edolk\Desktop\Other java projects\ZircPrototype\zircdemo\target\classes\edolkh1\zirc\display\EquipmentMenu$WeaponSlotButtonFunction$1.class", "Java", 0, 12, 0, 0, 12
"c:\Users\Edolk\Desktop\Other java projects\ZircPrototype\zircdemo\target\classes\edolkh1\zirc\display\EquipmentMenu$WeaponSlotButtonFunction.class", "Java", 0, 23, 0, 0, 23
"c:\Users\Edolk\Desktop\Other java projects\ZircPrototype\zircdemo\target\classes\edolkh1\zirc\display\EquipmentMenu$WeaponSlotExamineFunction$1.class", "Java", 0, 15, 0, 1, 16
"c:\Users\Edolk\Desktop\Other java projects\ZircPrototype\zircdemo\target\classes\edolkh1\zirc\display\EquipmentMenu$WeaponSlotExamineFunction.class", "Java", 0, 9, 0, 0, 9
"c:\Users\Edolk\Desktop\Other java projects\ZircPrototype\zircdemo\target\classes\edolkh1\zirc\display\EquipmentMenu.class", "Java", 0, 75, 0, 0, 75
"c:\Users\Edolk\Desktop\Other java projects\ZircPrototype\zircdemo\target\classes\edolkh1\zirc\display\ExamineMenu.class", "Java", 0, 91, 0, 0, 91
"c:\Users\Edolk\Desktop\Other java projects\ZircPrototype\zircdemo\target\classes\edolkh1\zirc\display\FloorMenu$State.class", "Java", 0, 15, 0, 0, 15
"c:\Users\Edolk\Desktop\Other java projects\ZircPrototype\zircdemo\target\classes\edolkh1\zirc\display\FloorMenu.class", "Java", 0, 256, 0, 0, 256
"c:\Users\Edolk\Desktop\Other java projects\ZircPrototype\zircdemo\target\classes\edolkh1\zirc\display\ItemContextMenu.class", "Java", 0, 108, 0, 0, 108
"c:\Users\Edolk\Desktop\Other java projects\ZircPrototype\zircdemo\target\classes\edolkh1\zirc\display\ItemSelectMenu$1.class", "Java", 0, 24, 0, 0, 24
"c:\Users\Edolk\Desktop\Other java projects\ZircPrototype\zircdemo\target\classes\edolkh1\zirc\display\ItemSelectMenu.class", "Java", 0, 110, 0, 0, 110
"c:\Users\Edolk\Desktop\Other java projects\ZircPrototype\zircdemo\target\classes\edolkh1\zirc\display\Menu.class", "Java", 0, 24, 0, 0, 24
"c:\Users\Edolk\Desktop\Other java projects\ZircPrototype\zircdemo\target\classes\edolkh1\zirc\display\PauseMenu.class", "Java", 0, 36, 0, 0, 36
"c:\Users\Edolk\Desktop\Other java projects\ZircPrototype\zircdemo\target\classes\edolkh1\zirc\floorgeneration\ArmorFactory$1.class", "Java", 0, 7, 0, 1, 8
"c:\Users\Edolk\Desktop\Other java projects\ZircPrototype\zircdemo\target\classes\edolkh1\zirc\floorgeneration\ArmorFactory.class", "Java", 0, 23, 0, 0, 23
"c:\Users\Edolk\Desktop\Other java projects\ZircPrototype\zircdemo\target\classes\edolkh1\zirc\floorgeneration\DefaultFloorGenerator.class", "Java", 0, 86, 0, 0, 86
"c:\Users\Edolk\Desktop\Other java projects\ZircPrototype\zircdemo\target\classes\edolkh1\zirc\floorgeneration\EntityFactory$EntityIdentifier.class", "Java", 0, 14, 0, 0, 14
"c:\Users\Edolk\Desktop\Other java projects\ZircPrototype\zircdemo\target\classes\edolkh1\zirc\floorgeneration\EntityFactory.class", "Java", 0, 22, 0, 0, 22
"c:\Users\Edolk\Desktop\Other java projects\ZircPrototype\zircdemo\target\classes\edolkh1\zirc\floorgeneration\FloorGenerator.class", "Java", 0, 20, 0, 0, 20
"c:\Users\Edolk\Desktop\Other java projects\ZircPrototype\zircdemo\target\classes\edolkh1\zirc\floorgeneration\ItemFactory$ItemIdentifier.class", "Java", 0, 22, 0, 0, 22
"c:\Users\Edolk\Desktop\Other java projects\ZircPrototype\zircdemo\target\classes\edolkh1\zirc\floorgeneration\ItemFactory.class", "Java", 0, 58, 0, 0, 58
"c:\Users\Edolk\Desktop\Other java projects\ZircPrototype\zircdemo\target\classes\edolkh1\zirc\floorgeneration\Pool.class", "Java", 0, 25, 0, 0, 25
"c:\Users\Edolk\Desktop\Other java projects\ZircPrototype\zircdemo\target\classes\edolkh1\zirc\floorgeneration\Pools.class", "Java", 0, 23, 0, 0, 23
"c:\Users\Edolk\Desktop\Other java projects\ZircPrototype\zircdemo\target\classes\edolkh1\zirc\floorgeneration\WeaponFactory$1.class", "Java", 0, 7, 0, 1, 8
"c:\Users\Edolk\Desktop\Other java projects\ZircPrototype\zircdemo\target\classes\edolkh1\zirc\floorgeneration\WeaponFactory.class", "Java", 0, 23, 0, 0, 23
"c:\Users\Edolk\Desktop\Other java projects\ZircPrototype\zircdemo\target\classes\edolkh1\zirc\gamelogic\Aimable.class", "Java", 0, 5, 0, 0, 5
"c:\Users\Edolk\Desktop\Other java projects\ZircPrototype\zircdemo\target\classes\edolkh1\zirc\gamelogic\Armed.class", "Java", 0, 12, 0, 0, 12
"c:\Users\Edolk\Desktop\Other java projects\ZircPrototype\zircdemo\target\classes\edolkh1\zirc\gamelogic\Armored.class", "Java", 0, 10, 0, 0, 10
"c:\Users\Edolk\Desktop\Other java projects\ZircPrototype\zircdemo\target\classes\edolkh1\zirc\gamelogic\Consumable.class", "Java", 0, 5, 0, 0, 5
"c:\Users\Edolk\Desktop\Other java projects\ZircPrototype\zircdemo\target\classes\edolkh1\zirc\gamelogic\Damageable.class", "Java", 0, 3, 0, 0, 3
"c:\Users\Edolk\Desktop\Other java projects\ZircPrototype\zircdemo\target\classes\edolkh1\zirc\gamelogic\DropsXP.class", "Java", 0, 2, 0, 0, 2
"c:\Users\Edolk\Desktop\Other java projects\ZircPrototype\zircdemo\target\classes\edolkh1\zirc\gamelogic\Examinable.class", "Java", 0, 4, 0, 0, 4
"c:\Users\Edolk\Desktop\Other java projects\ZircPrototype\zircdemo\target\classes\edolkh1\zirc\gamelogic\Experiential.class", "Java", 0, 3, 0, 0, 3
"c:\Users\Edolk\Desktop\Other java projects\ZircPrototype\zircdemo\target\classes\edolkh1\zirc\gamelogic\Flammable.class", "Java", 0, 2, 0, 1, 3
"c:\Users\Edolk\Desktop\Other java projects\ZircPrototype\zircdemo\target\classes\edolkh1\zirc\gamelogic\HasAccuracy.class", "Java", 0, 2, 0, 0, 2
"c:\Users\Edolk\Desktop\Other java projects\ZircPrototype\zircdemo\target\classes\edolkh1\zirc\gamelogic\HasDodge.class", "Java", 0, 3, 0, 0, 3
"c:\Users\Edolk\Desktop\Other java projects\ZircPrototype\zircdemo\target\classes\edolkh1\zirc\gamelogic\HasDrops.class", "Java", 0, 23, 0, 0, 23
"c:\Users\Edolk\Desktop\Other java projects\ZircPrototype\zircdemo\target\classes\edolkh1\zirc\gamelogic\HasInventory.class", "Java", 0, 19, 0, 0, 19
"c:\Users\Edolk\Desktop\Other java projects\ZircPrototype\zircdemo\target\classes\edolkh1\zirc\gamelogic\HasResistances.class", "Java", 0, 10, 0, 0, 10
"c:\Users\Edolk\Desktop\Other java projects\ZircPrototype\zircdemo\target\classes\edolkh1\zirc\gamelogic\Interactable.class", "Java", 0, 3, 0, 0, 3
"c:\Users\Edolk\Desktop\Other java projects\ZircPrototype\zircdemo\target\classes\edolkh1\zirc\gamelogic\Levelable.class", "Java", 0, 2, 0, 0, 2
"c:\Users\Edolk\Desktop\Other java projects\ZircPrototype\zircdemo\target\classes\edolkh1\zirc\gamelogic\LightSource.class", "Java", 0, 2, 0, 0, 2
"c:\Users\Edolk\Desktop\Other java projects\ZircPrototype\zircdemo\target\classes\edolkh1\zirc\gamelogic\OverridesAttack.class", "Java", 0, 2, 0, 0, 2
"c:\Users\Edolk\Desktop\Other java projects\ZircPrototype\zircdemo\target\classes\edolkh1\zirc\gamelogic\OverridesMovement.class", "Java", 0, 2, 0, 0, 2
"c:\Users\Edolk\Desktop\Other java projects\ZircPrototype\zircdemo\target\classes\edolkh1\zirc\gamelogic\Scrollable.class", "Java", 0, 2, 0, 1, 3
"c:\Users\Edolk\Desktop\Other java projects\ZircPrototype\zircdemo\target\classes\edolkh1\zirc\gamelogic\SelfAware.class", "Java", 0, 13, 0, 0, 13
"c:\Users\Edolk\Desktop\Other java projects\ZircPrototype\zircdemo\target\classes\edolkh1\zirc\gamelogic\Triggerable.class", "Java", 0, 2, 0, 1, 3
"c:\Users\Edolk\Desktop\Other java projects\ZircPrototype\zircdemo\target\classes\edolkh1\zirc\gamelogic\Upgradable.class", "Java", 0, 2, 0, 0, 2
"c:\Users\Edolk\Desktop\Other java projects\ZircPrototype\zircdemo\target\classes\edolkh1\zirc\gamelogic\Upgrader.class", "Java", 0, 3, 0, 0, 3
"c:\Users\Edolk\Desktop\Other java projects\ZircPrototype\zircdemo\target\classes\edolkh1\zirc\gamelogic\behavior\Behavable.class", "Java", 0, 2, 0, 1, 3
"c:\Users\Edolk\Desktop\Other java projects\ZircPrototype\zircdemo\target\classes\edolkh1\zirc\gamelogic\behavior\Behavior.class", "Java", 0, 6, 0, 0, 6
"c:\Users\Edolk\Desktop\Other java projects\ZircPrototype\zircdemo\target\classes\edolkh1\zirc\gamelogic\behavior\HasBehavior.class", "Java", 0, 12, 0, 0, 12
"c:\Users\Edolk\Desktop\Other java projects\ZircPrototype\zircdemo\target\classes\edolkh1\zirc\gamelogic\combat\OnAttack.class", "Java", 0, 3, 0, 0, 3
"c:\Users\Edolk\Desktop\Other java projects\ZircPrototype\zircdemo\target\classes\edolkh1\zirc\gamelogic\combat\OnAttacked.class", "Java", 0, 3, 0, 0, 3
"c:\Users\Edolk\Desktop\Other java projects\ZircPrototype\zircdemo\target\classes\edolkh1\zirc\gamelogic\combat\OnCrit.class", "Java", 0, 2, 0, 0, 2
"c:\Users\Edolk\Desktop\Other java projects\ZircPrototype\zircdemo\target\classes\edolkh1\zirc\gamelogic\combat\OnCritted.class", "Java", 0, 2, 0, 0, 2
"c:\Users\Edolk\Desktop\Other java projects\ZircPrototype\zircdemo\target\classes\edolkh1\zirc\gamelogic\combat\OnHit.class", "Java", 0, 3, 0, 0, 3
"c:\Users\Edolk\Desktop\Other java projects\ZircPrototype\zircdemo\target\classes\edolkh1\zirc\gamelogic\combat\OnHitted.class", "Java", 0, 3, 0, 0, 3
"c:\Users\Edolk\Desktop\Other java projects\ZircPrototype\zircdemo\target\classes\edolkh1\zirc\gamelogic\combat\OnMiss.class", "Java", 0, 2, 0, 0, 2
"c:\Users\Edolk\Desktop\Other java projects\ZircPrototype\zircdemo\target\classes\edolkh1\zirc\gamelogic\combat\OnMissed.class", "Java", 0, 3, 0, 0, 3
"c:\Users\Edolk\Desktop\Other java projects\ZircPrototype\zircdemo\target\classes\edolkh1\zirc\gamelogic\resistances\FlatResistance.class", "Java", 0, 22, 2, 0, 24
"c:\Users\Edolk\Desktop\Other java projects\ZircPrototype\zircdemo\target\classes\edolkh1\zirc\gamelogic\resistances\PercentageResistance.class", "Java", 0, 32, 0, 0, 32
"c:\Users\Edolk\Desktop\Other java projects\ZircPrototype\zircdemo\target\classes\edolkh1\zirc\gamelogic\resistances\RangeResistance.class", "Java", 0, 31, 4, 0, 35
"c:\Users\Edolk\Desktop\Other java projects\ZircPrototype\zircdemo\target\classes\edolkh1\zirc\gamelogic\resistances\Resistance.class", "Java", 0, 8, 0, 0, 8
"c:\Users\Edolk\Desktop\Other java projects\ZircPrototype\zircdemo\target\classes\edolkh1\zirc\gameobjects\ArmorSlot.class", "Java", 0, 26, 0, 0, 26
"c:\Users\Edolk\Desktop\Other java projects\ZircPrototype\zircdemo\target\classes\edolkh1\zirc\gameobjects\DamageType.class", "Java", 0, 16, 0, 0, 16
"c:\Users\Edolk\Desktop\Other java projects\ZircPrototype\zircdemo\target\classes\edolkh1\zirc\gameobjects\DisplayableTile.class", "Java", 0, 52, 0, 0, 52
"c:\Users\Edolk\Desktop\Other java projects\ZircPrototype\zircdemo\target\classes\edolkh1\zirc\gameobjects\Floor.class", "Java", 0, 116, 0, 1, 117
"c:\Users\Edolk\Desktop\Other java projects\ZircPrototype\zircdemo\target\classes\edolkh1\zirc\gameobjects\Space$SpaceOccupiedException.class", "Java", 0, 10, 0, 0, 10
"c:\Users\Edolk\Desktop\Other java projects\ZircPrototype\zircdemo\target\classes\edolkh1\zirc\gameobjects\Space.class", "Java", 0, 39, 17, 0, 56
"c:\Users\Edolk\Desktop\Other java projects\ZircPrototype\zircdemo\target\classes\edolkh1\zirc\gameobjects\WeaponSlot.class", "Java", 0, 22, 0, 0, 22
"c:\Users\Edolk\Desktop\Other java projects\ZircPrototype\zircdemo\target\classes\edolkh1\zirc\gameobjects\enchantments\ArmorEnchantment.class", "Java", 0, 5, 0, 0, 5
"c:\Users\Edolk\Desktop\Other java projects\ZircPrototype\zircdemo\target\classes\edolkh1\zirc\gameobjects\enchantments\Enchantment.class", "Java", 0, 17, 0, 0, 17
"c:\Users\Edolk\Desktop\Other java projects\ZircPrototype\zircdemo\target\classes\edolkh1\zirc\gameobjects\enchantments\Lucky.class", "Java", 0, 14, 0, 0, 14
"c:\Users\Edolk\Desktop\Other java projects\ZircPrototype\zircdemo\target\classes\edolkh1\zirc\gameobjects\enchantments\WeaponEnchantment.class", "Java", 0, 5, 0, 0, 5
"c:\Users\Edolk\Desktop\Other java projects\ZircPrototype\zircdemo\target\classes\edolkh1\zirc\gameobjects\entities\Animal$Hunting.class", "Java", 0, 32, 0, 1, 33
"c:\Users\Edolk\Desktop\Other java projects\ZircPrototype\zircdemo\target\classes\edolkh1\zirc\gameobjects\entities\Animal$Wandering.class", "Java", 0, 55, 0, 1, 56
"c:\Users\Edolk\Desktop\Other java projects\ZircPrototype\zircdemo\target\classes\edolkh1\zirc\gameobjects\entities\Animal.class", "Java", 0, 13, 0, 0, 13
"c:\Users\Edolk\Desktop\Other java projects\ZircPrototype\zircdemo\target\classes\edolkh1\zirc\gameobjects\entities\Chest$1.class", "Java", 0, 12, 0, 0, 12
"c:\Users\Edolk\Desktop\Other java projects\ZircPrototype\zircdemo\target\classes\edolkh1\zirc\gameobjects\entities\Chest.class", "Java", 0, 32, 0, 1, 33
"c:\Users\Edolk\Desktop\Other java projects\ZircPrototype\zircdemo\target\classes\edolkh1\zirc\gameobjects\entities\DireRat.class", "Java", 0, 25, 0, 0, 25
"c:\Users\Edolk\Desktop\Other java projects\ZircPrototype\zircdemo\target\classes\edolkh1\zirc\gameobjects\entities\Door.class", "Java", 0, 47, 0, 1, 48
"c:\Users\Edolk\Desktop\Other java projects\ZircPrototype\zircdemo\target\classes\edolkh1\zirc\gameobjects\entities\Entity.class", "Java", 0, 136, 0, 0, 136
"c:\Users\Edolk\Desktop\Other java projects\ZircPrototype\zircdemo\target\classes\edolkh1\zirc\gameobjects\entities\EvaporatedSlime.class", "Java", 0, 38, 0, 0, 38
"c:\Users\Edolk\Desktop\Other java projects\ZircPrototype\zircdemo\target\classes\edolkh1\zirc\gameobjects\entities\PlayerEntity.class", "Java", 0, 67, 0, 0, 67
"c:\Users\Edolk\Desktop\Other java projects\ZircPrototype\zircdemo\target\classes\edolkh1\zirc\gameobjects\entities\Rat.class", "Java", 0, 33, 0, 0, 33
"c:\Users\Edolk\Desktop\Other java projects\ZircPrototype\zircdemo\target\classes\edolkh1\zirc\gameobjects\entities\Slime.class", "Java", 0, 58, 14, 0, 72
"c:\Users\Edolk\Desktop\Other java projects\ZircPrototype\zircdemo\target\classes\edolkh1\zirc\gameobjects\entities\Snake.class", "Java", 0, 35, 0, 0, 35
"c:\Users\Edolk\Desktop\Other java projects\ZircPrototype\zircdemo\target\classes\edolkh1\zirc\gameobjects\entities\Spider$HiddenWeb.class", "Java", 0, 6, 0, 0, 6
"c:\Users\Edolk\Desktop\Other java projects\ZircPrototype\zircdemo\target\classes\edolkh1\zirc\gameobjects\entities\Spider$Nesting.class", "Java", 0, 54, 0, 1, 55
"c:\Users\Edolk\Desktop\Other java projects\ZircPrototype\zircdemo\target\classes\edolkh1\zirc\gameobjects\entities\Spider$Trapping.class", "Java", 0, 44, 0, 1, 45
"c:\Users\Edolk\Desktop\Other java projects\ZircPrototype\zircdemo\target\classes\edolkh1\zirc\gameobjects\entities\Spider$Waiting.class", "Java", 0, 10, 0, 0, 10
"c:\Users\Edolk\Desktop\Other java projects\ZircPrototype\zircdemo\target\classes\edolkh1\zirc\gameobjects\entities\Spider$Wandering.class", "Java", 0, 43, 0, 0, 43
"c:\Users\Edolk\Desktop\Other java projects\ZircPrototype\zircdemo\target\classes\edolkh1\zirc\gameobjects\entities\Spider$Web.class", "Java", 0, 37, 0, 0, 37
"c:\Users\Edolk\Desktop\Other java projects\ZircPrototype\zircdemo\target\classes\edolkh1\zirc\gameobjects\entities\Spider$Webbed.class", "Java", 0, 23, 0, 0, 23
"c:\Users\Edolk\Desktop\Other java projects\ZircPrototype\zircdemo\target\classes\edolkh1\zirc\gameobjects\entities\Spider.class", "Java", 0, 33, 0, 0, 33
"c:\Users\Edolk\Desktop\Other java projects\ZircPrototype\zircdemo\target\classes\edolkh1\zirc\gameobjects\entities\ThrownItem.class", "Java", 0, 49, 0, 0, 49
"c:\Users\Edolk\Desktop\Other java projects\ZircPrototype\zircdemo\target\classes\edolkh1\zirc\gameobjects\entities\Wall.class", "Java", 0, 45, 0, 0, 45
"c:\Users\Edolk\Desktop\Other java projects\ZircPrototype\zircdemo\target\classes\edolkh1\zirc\gameobjects\entities\statuses\Burning.class", "Java", 0, 63, 0, 1, 64
"c:\Users\Edolk\Desktop\Other java projects\ZircPrototype\zircdemo\target\classes\edolkh1\zirc\gameobjects\entities\statuses\Flying.class", "Java", 0, 25, 0, 0, 25
"c:\Users\Edolk\Desktop\Other java projects\ZircPrototype\zircdemo\target\classes\edolkh1\zirc\gameobjects\entities\statuses\Healing.class", "Java", 0, 26, 1, 0, 27
"c:\Users\Edolk\Desktop\Other java projects\ZircPrototype\zircdemo\target\classes\edolkh1\zirc\gameobjects\entities\statuses\Poisoned.class", "Java", 0, 28, 0, 0, 28
"c:\Users\Edolk\Desktop\Other java projects\ZircPrototype\zircdemo\target\classes\edolkh1\zirc\gameobjects\entities\statuses\Status.class", "Java", 0, 11, 0, 0, 11
"c:\Users\Edolk\Desktop\Other java projects\ZircPrototype\zircdemo\target\classes\edolkh1\zirc\gameobjects\entities\statuses\Wet.class", "Java", 0, 64, 0, 2, 66
"c:\Users\Edolk\Desktop\Other java projects\ZircPrototype\zircdemo\target\classes\edolkh1\zirc\gameobjects\items\CookedCorpse.class", "Java", 0, 20, 0, 0, 20
"c:\Users\Edolk\Desktop\Other java projects\ZircPrototype\zircdemo\target\classes\edolkh1\zirc\gameobjects\items\Corpse.class", "Java", 0, 67, 0, 0, 67
"c:\Users\Edolk\Desktop\Other java projects\ZircPrototype\zircdemo\target\classes\edolkh1\zirc\gameobjects\items\Item.class", "Java", 0, 23, 0, 0, 23
"c:\Users\Edolk\Desktop\Other java projects\ZircPrototype\zircdemo\target\classes\edolkh1\zirc\gameobjects\items\armor\Armor.class", "Java", 0, 15, 0, 0, 15
"c:\Users\Edolk\Desktop\Other java projects\ZircPrototype\zircdemo\target\classes\edolkh1\zirc\gameobjects\items\armor\ArmorType.class", "Java", 0, 24, 0, 0, 24
"c:\Users\Edolk\Desktop\Other java projects\ZircPrototype\zircdemo\target\classes\edolkh1\zirc\gameobjects\items\armor\Chainmail.class", "Java", 0, 15, 0, 0, 15
"c:\Users\Edolk\Desktop\Other java projects\ZircPrototype\zircdemo\target\classes\edolkh1\zirc\gameobjects\items\armor\Cloak.class", "Java", 0, 14, 0, 0, 14
"c:\Users\Edolk\Desktop\Other java projects\ZircPrototype\zircdemo\target\classes\edolkh1\zirc\gameobjects\items\armor\IronGreaves.class", "Java", 0, 15, 0, 0, 15
"c:\Users\Edolk\Desktop\Other java projects\ZircPrototype\zircdemo\target\classes\edolkh1\zirc\gameobjects\items\armor\IronHelm.class", "Java", 0, 15, 0, 0, 15
"c:\Users\Edolk\Desktop\Other java projects\ZircPrototype\zircdemo\target\classes\edolkh1\zirc\gameobjects\items\armor\LeatherArmor.class", "Java", 0, 14, 0, 0, 14
"c:\Users\Edolk\Desktop\Other java projects\ZircPrototype\zircdemo\target\classes\edolkh1\zirc\gameobjects\items\armor\LeatherCap.class", "Java", 0, 14, 0, 0, 14
"c:\Users\Edolk\Desktop\Other java projects\ZircPrototype\zircdemo\target\classes\edolkh1\zirc\gameobjects\items\armor\LeatherGloves.class", "Java", 0, 13, 0, 0, 13
"c:\Users\Edolk\Desktop\Other java projects\ZircPrototype\zircdemo\target\classes\edolkh1\zirc\gameobjects\items\armor\LeatherPants.class", "Java", 0, 14, 0, 0, 14
"c:\Users\Edolk\Desktop\Other java projects\ZircPrototype\zircdemo\target\classes\edolkh1\zirc\gameobjects\items\armor\PlateArmor.class", "Java", 0, 15, 0, 0, 15
"c:\Users\Edolk\Desktop\Other java projects\ZircPrototype\zircdemo\target\classes\edolkh1\zirc\gameobjects\items\armor\PlateGauntlets.class", "Java", 0, 14, 0, 0, 14
"c:\Users\Edolk\Desktop\Other java projects\ZircPrototype\zircdemo\target\classes\edolkh1\zirc\gameobjects\items\potions\FirePotion.class", "Java", 0, 42, 0, 1, 43
"c:\Users\Edolk\Desktop\Other java projects\ZircPrototype\zircdemo\target\classes\edolkh1\zirc\gameobjects\items\potions\HealingPotion.class", "Java", 0, 30, 0, 0, 30
"c:\Users\Edolk\Desktop\Other java projects\ZircPrototype\zircdemo\target\classes\edolkh1\zirc\gameobjects\items\potions\LiquidPotion.class", "Java", 0, 16, 0, 1, 17
"c:\Users\Edolk\Desktop\Other java projects\ZircPrototype\zircdemo\target\classes\edolkh1\zirc\gameobjects\items\potions\WaterPotion.class", "Java", 0, 28, 0, 0, 28
"c:\Users\Edolk\Desktop\Other java projects\ZircPrototype\zircdemo\target\classes\edolkh1\zirc\gameobjects\items\scrolls\ScrollOfUpgrade.class", "Java", 0, 27, 0, 0, 27
"c:\Users\Edolk\Desktop\Other java projects\ZircPrototype\zircdemo\target\classes\edolkh1\zirc\gameobjects\items\weapons\BoStaff.class", "Java", 0, 28, 0, 0, 28
"c:\Users\Edolk\Desktop\Other java projects\ZircPrototype\zircdemo\target\classes\edolkh1\zirc\gameobjects\items\weapons\Dagger.class", "Java", 0, 24, 0, 0, 24
"c:\Users\Edolk\Desktop\Other java projects\ZircPrototype\zircdemo\target\classes\edolkh1\zirc\gameobjects\items\weapons\HandAxe.class", "Java", 0, 14, 0, 0, 14
"c:\Users\Edolk\Desktop\Other java projects\ZircPrototype\zircdemo\target\classes\edolkh1\zirc\gameobjects\items\weapons\ShortSword.class", "Java", 0, 15, 0, 0, 15
"c:\Users\Edolk\Desktop\Other java projects\ZircPrototype\zircdemo\target\classes\edolkh1\zirc\gameobjects\items\weapons\Weapon.class", "Java", 0, 20, 0, 0, 20
"c:\Users\Edolk\Desktop\Other java projects\ZircPrototype\zircdemo\target\classes\edolkh1\zirc\gameobjects\terrains\ExposedTrap.class", "Java", 0, 5, 0, 0, 5
"c:\Users\Edolk\Desktop\Other java projects\ZircPrototype\zircdemo\target\classes\edolkh1\zirc\gameobjects\terrains\Fire.class", "Java", 0, 60, 0, 0, 60
"c:\Users\Edolk\Desktop\Other java projects\ZircPrototype\zircdemo\target\classes\edolkh1\zirc\gameobjects\terrains\HiddenTrap.class", "Java", 0, 25, 0, 0, 25
"c:\Users\Edolk\Desktop\Other java projects\ZircPrototype\zircdemo\target\classes\edolkh1\zirc\gameobjects\terrains\OpenDoor.class", "Java", 0, 35, 0, 0, 35
"c:\Users\Edolk\Desktop\Other java projects\ZircPrototype\zircdemo\target\classes\edolkh1\zirc\gameobjects\terrains\Staircase.class", "Java", 0, 17, 0, 0, 17
"c:\Users\Edolk\Desktop\Other java projects\ZircPrototype\zircdemo\target\classes\edolkh1\zirc\gameobjects\terrains\Terrain.class", "Java", 0, 11, 0, 0, 11
"c:\Users\Edolk\Desktop\Other java projects\ZircPrototype\zircdemo\target\classes\edolkh1\zirc\gameobjects\terrains\Trap.class", "Java", 0, 5, 0, 0, 5
"c:\Users\Edolk\Desktop\Other java projects\ZircPrototype\zircdemo\target\classes\edolkh1\zirc\gameobjects\terrains\gasses\Gas.class", "Java", 0, 62, 0, 0, 62
"c:\Users\Edolk\Desktop\Other java projects\ZircPrototype\zircdemo\target\classes\edolkh1\zirc\gameobjects\terrains\gasses\Miasma.class", "Java", 0, 35, 0, 1, 36
"c:\Users\Edolk\Desktop\Other java projects\ZircPrototype\zircdemo\target\classes\edolkh1\zirc\gameobjects\terrains\gasses\Steam.class", "Java", 0, 16, 0, 0, 16
"c:\Users\Edolk\Desktop\Other java projects\ZircPrototype\zircdemo\target\classes\edolkh1\zirc\gameobjects\terrains\liquids\Liquid.class", "Java", 0, 57, 0, 1, 58
"c:\Users\Edolk\Desktop\Other java projects\ZircPrototype\zircdemo\target\classes\edolkh1\zirc\gameobjects\terrains\liquids\Water.class", "Java", 0, 40, 4, 0, 44
"c:\Users\Edolk\Desktop\Other java projects\ZircPrototype\zircdemo\target\test-classes\edolkh1\zirc\AppTest$ExampleGasSubtype.class", "Java", 0, 24, 0, 0, 24
"c:\Users\Edolk\Desktop\Other java projects\ZircPrototype\zircdemo\target\test-classes\edolkh1\zirc\AppTest$ExampleMiasmaSubtype.class", "Java", 0, 8, 0, 0, 8
"c:\Users\Edolk\Desktop\Other java projects\ZircPrototype\zircdemo\target\test-classes\edolkh1\zirc\AppTest.class", "Java", 0, 24, 0, 0, 24
"Total", "-", 133, 11954, 133, 1847, 14067